|-----------------------|
||         Map         ||
|-----------------------|
||(Mines)----(Jojamart)||
||   |          |      ||
||(*Farm*)----(Town)   ||
|-----------------------|